[
{
    "type": "furniture",
    "id": "f_stone_throne",
    "name": "stone throne",
	"looks_like": "f_grave_stone",
    "description": "An upright slab of stone, presumably for whoever lies beneath.",
    "symbol": "^",
    "color": "light_gray",
    "move_cost_mod": 2,
    "coverage": 50,
    "required_str": -1,
    "crafting_pseudo_item": "boulder_anvil",
    "flags": [ "MINEABLE", "NOITEM", "TRANSPARENT", "MOUNTABLE", "ROUGH", "PLACE_ITEM", "CAN_SIT" ],
	"examine_action": {
      "type": "effect_on_condition",
      "effect_on_conditions": [
        {
          "id": "EOC_THRONE",
          "condition": {
      "and": [
        {
          "not": {
            "or": [
              { "u_is_wearing": "pact_of_bile" },
              { "u_is_wearing": "pact_of_blood" },
              { "u_is_wearing": "pact_of_smoke" },
              { "u_is_wearing": "pact_of_flame" },
			  { "u_has_trait": "PYSCHOPATH" }
            ]
          }
        },
        {
          "and": [
            { "u_is_wearing": "ortiels_aura" },
            { "u_is_wearing": "omnaths_aura" },
            { "u_is_wearing": "yidris_aura" },
            { "u_is_wearing": "atraxas_aura" }
          ]
        },
        {
          "and": [
            { "u_query": "Do you break the four contracts' seals at the foot of their origin, drawing the ire of their infernal creditor?", "default": true }
          ]
        }
      ]
    },
     "effect": [
      { "u_cast_spell": { "id": "summon_devil", "hit_self": true } }
	],
     "false_effect": [ 
	 { "u_message": "You read the inscription on the throne: 'Here rests the Prince of Darkness, the four Kings who lay at his feet having cast for him a Throne.'", "popup": true }, 
	 {
      "u_add_morale": "morale_feeling_good",
      "bonus": 10,
      "max_bonus": 10,
      "duration": "24 hours",
      "decay_start": "24 hours"
    } 
	]
    }
	]
	},
    "bash": {
      "str_min": 60,
      "str_max": 160,
      "sound": "crash!",
      "sound_fail": "thump!",
      "items": [ { "item": "rock", "count": [ 8, 14 ] }, { "item": "brimstone_sliver", "count": [ 8, 14 ] } ]
    }
  },
  {
    "type": "palette",
    "id": "demonfort_palette",
    "terrain": {
      " ": "t_floor_metal_gangway",
      "d": "t_floor_metal_gangway",
      "W": "t_rock_smooth",
      "D": "t_door_metal_bulkhead_o",
      "s": "t_floor_metal_gangway",
      ".": "t_concrete",
      ",": "t_thconc_floor",
      "&": "t_thconc_floor",
      "T": "t_thconc_floor",
      "t": "t_thconc_floor",
      "6": "t_concrete",
      "R": "t_concrete",
      "b": "t_concrete",
      "F": "t_concrete",
      "Y": "t_concrete",
      "#": "t_concrete",
      "L": "t_concrete",
      "B": "t_concrete",
      "w": "t_concrete",
      "X": "t_concrete",
      "=": "t_concrete",
      "c": "t_concrete",
      "A": "t_open_air",
      ">": "t_slope_down",
      "<": "t_slope_up",
      "f": "t_rock_floor_no_roof",
      "O": "t_concrete"
    },
    "furniture": {
      "c": "f_arcade_machine",
      "T": "f_toilet",
      "&": "f_machinery_old",
      "#": "f_displaycase",
      "6": "f_alien_scar",
      "R": "f_rack_wood",
      "b": "f_target",
	  "7": "f_magic_circle",
      "F": "f_grave_stone",
      "Y": "f_dancing_pole",
      "L": "f_alien_pod",
      "t": "f_trashcan",
      "B": "f_alien_table",
      "w": "f_locker",
      "X": "f_crate_c",
      "=": "f_piano"
    },
    "toilets": { "T": {  } }
  },
  {
    "type": "mapgen",
    "method": "json",
    "om_terrain": [
      [ "demonfort_1a", "demonfort_2a", "demonfort_3a", "demonfort_4a" ],
      [ "demonfort_1b", "demonfort_2b", "demonfort_3b", "demonfort_4b" ],
      [ "demonfort_1c", "demonfort_2c", "demonfort_3c", "demonfort_4c" ]
    ],
    "weight": 250,
    "object": {
      "fill_ter": "t_floor_metal_gangway",
      "rows": [
        "                                                                                                ",
        "                                         WWW                                                    ",
        "                                        WWWWW                                                   ",
        "                                       WWWWWWW                                                  ",
        "                                      WWWWWWWWW                                                 ",
        "                                     WWWW.O.WWWW                                                ",
        "                                    WWWW.....WWWW                                               ",
        "                                   WWWWX.....XWWWW                                              ",
        "                                  WWWWX...=...XWWWW                                             ",
        "                                  WWWX.........XWWW                                             ",
        "                                  WWWWWXX...XXWWWWW                                             ",
        "                                    WWWWWWDWWWWWW                                               ",
        "    WWWWWWW                        WWWWWW   WWWWWW                         WWWWW                ",
        "   WWWWWWWWWW                   WWWWWW         WWWWWWW                  WWWWWWWWWW              ",
        "  WWWWWWWWWWWWW               WWWWWW            WWWWWWW               WWWWWWWWWWWWW             ",
        "  WWWBwwB.BWWWWW           WWWWWWW  7        7    WWWWWWW            WWWWWLLLLLtWWW             ",
        "  WWWB..B.B.WWWWWWWWWWWWWWWWWWWW                    WWWWWWWWWWWWWWWWWWWWW.......WWW             ",
        "  WWW..Y....YWWWWWWWWWWWWWWWWW                  7     WWWWWWWWWWWWWWWWWW........WWW             ",
        "  WWWBB.B.B...WWWWWWWWWWWWW    7                         WWWWWWWWWWWWWW..cYc.bbFWWW             ",
        "   WWWWWB.B...D  WWWWWWW<<<                           7  <<<WWWWWWWWWWWDWWWWWWWWWW              ",
        "    WWWWWWWWWWW                                                         WWWWWWWWW               ",
        "     WWWWWWWWWW         7                                 7            WWWWWWWWW                ",
        "           WWWW                                                        WWWW                     ",
        "             WWW                                               7      WWW                       ",
        "             WWW                                                      WWW                       ",
        "             WWW                                                      WWW                       ",
        "              WWW    7                                               WWW                        ",
        "              WWW                                             7      WWW                        ",
        "              WWW                                                    WWW                        ",
        "              WWW                         ?                          WWW                        ",
        "               WWW   7                                              WWW                         ",
        "               WWW                                           7      WWW                         ",
        "               WWW                                                  WWW                         ",
        "               WWW                                                  WWW                         ",
        "               WWW                                                  WWW                         ",
        "               WWW    7                                             WWW                         ",
        "                WWW                                         7      WWW                          ",
        "                WWW                                                WWW                          ",
        "                WWW                     ddddd                      WWW                          ",
        "                WWW                     ddddd                      WWW                          ",
        "                WWW                     ddddd              7       WWW                          ",
        "                 WWW   7                ddddd                     WWW                           ",
        "                 WWW                    ddddd                     WWW                           ",
        "                 WWW                    ddddd                     WWW                           ",
        "                 WWW       7   7   7    ddddd   7   7    7        WWW                           ",
        "                  WWW    ssssssssssssssssssssssssssssssssss      WWW                            ",
        "                  WWWW  sssssssssssssssssssssssssssssssssssss   WWWW                            ",
        "                WWWWWWWssssssWWWWWWWWWWWsssssWWWWWWWWWWWsssssssWWWWWW                           ",
        "                WWWWWWWssssWWWWWWWWWWWWWsssssWWWWWWWWWWWWWWssssWWWWWW                           ",
        "              WWWWWWWWWDWWWWWWWWWWWWWWWWsssssWWWWWWWWWWWWWWWWWDWWWWWWWW                         ",
        "            WWWWWTD,tW,,,WWWW                            WWWWW......WWWWW                       ",
        "            WWWWWWW,,D,,,WWW                              WWWR.......RWWWW                      ",
        "            WWWWT,D,&WWDWWWW                              WWWR..YYY..RWWWW                      ",
        "            WWWWWWWWWW,,WWW                                WWW..YYY..RWWWW                      ",
        "            WWWW&,,,,,,tWWW                                WWW.......RWWWW                      ",
        "             WWWWWDWDWWWWWW                                WWWWRR##6RWWWW                       ",
        "              WWWWTWTWWWW                                    WWWWW.cWWWW                        ",
        "               WWWWWWWWW                                      WWWWWWWWW                         ",
        "                WWWWWWW                                        WWWWWWW                          ",
        "                                                                                                ",
        "                                                                                                ",
        "                                                                                                ",
        "                                                                                                ",
        "                                                                                                ",
        "                                                                                                ",
        "                                                                                                ",
        "                                                                                                ",
        "                                                                                                ",
        "                                                                                                ",
        "                                                                                                ",
        "                                                                                                ",
        "                                                                                                "
      ],
      "palettes": [ "demonfort_palette" ],
      "items": {
        "t": [ { "item": "brimstone_ammunition", "chance": 50, "repeat": [ 3, 5 ] } ],
        "R": [ { "item": "spellbook_loot_2", "chance": 50, "repeat": [ 1, 3 ] } ],
        "#": [ { "item": "gloves", "chance": 75 } ],
        "L": { "item": "enchanted_combat_items", "chance": 70, "repeat": [ 1, 3 ] },
        "F": { "item": "enchanted_misc", "chance": 70, "repeat": [ 1, 3 ] },
        "w": { "item": "benjamins", "chance": 100, "repeat": [ 5, 10 ] },
        "=": { "item": "ammo_cannon", "chance": 100 },
        "X": { "item": "fort_crate", "chance": 70, "repeat": [ 1, 10 ] },
        "O": { "item": "fort_powderbarrel", "chance": 100 }
      },
	  "furniture": {
        "?": "f_stone_throne"
      },
      "place_loot": [  ],
      "place_monsters": [ { "monster": "GROUP_DEMONFORT", "x": [ 34, 40 ], "y": [ 30, 40 ], "repeat": [ 15, 20 ], "density": 0.1 } ]
    }
  },
  {
    "type": "mapgen",
    "method": "json",
    "om_terrain": [
      [ "demonfort_1a_1", "demonfort_2a_1", "demonfort_3a_1", "demonfort_4a_1" ],
      [ "demonfort_1b_1", "demonfort_2b_1", "demonfort_3b_1", "demonfort_4b_1" ],
      [ "demonfort_1c_1", "demonfort_2c_1", "demonfort_3c_1", "demonfort_4c_1" ]
    ],
    "weight": 250,
    "object": {
      "fill_ter": "t_floor_metal_gangway",
      "rows": [
        "AAAAAAAAAAAAAAAAAAAAAAAAAAAAAAAAAAAAAAAAAAAAAAAAAAAAAAAAAAAAAAAAAAAAAAAAAAAAAAAAAAAAAAAAAAAAAAAA",
        "AAAAAAAAAAAAAAAAAAAAAAAAAAAAAAAAAAAAAAAAAfffAAAAAAAAAAAAAAAAAAAAAAAAAAAAAAAAAAAAAAAAAAAAAAAAAAAA",
        "AAAAAAAAAAAAAAAAAAAAAAAAAAAAAAAAAAAAAAAAfffffAAAAAAAAAAAAAAAAAAAAAAAAAAAAAAAAAAAAAAAAAAAAAAAAAAA",
        "AAAAAAAAAAAAAAAAAAAAAAAAAAAAAAAAAAAAAAAfffffffAAAAAAAAAAAAAAAAAAAAAAAAAAAAAAAAAAAAAAAAAAAAAAAAAA",
        "AAAAAAAAAAAAAAAAAAAAAAAAAAAAAAAAAAAAAAfffffffffAAAAAAAAAAAAAAAAAAAAAAAAAAAAAAAAAAAAAAAAAAAAAAAAA",
        "AAAAAAAAAAAAAAAAAAAAAAAAAAAAAAAAAAAAAfffffUfffffAAAAAAAAAAAAAAAAAAAAAAAAAAAAAAAAAAAAAAAAAAAAAAAA",
        "AAAAAAAAAAAAAAAAAAAAAAAAAAAAAAAAAAAAfffffffffffffAAAAAAAAAAAAAAAAAAAAAAAAAAAAAAAAAAAAAAAAAAAAAAA",
        "AAAAAAAAAAAAAAAAAAAAAAAAAAAAAAAAAAAfffffffZfffffffAAAAAAAAAAAAAAAAAAAAAAAAAAAAAAAAAAAAAAAAAAAAAA",
        "AAAAAAAAAAAAAAAAAAAAAAAAAAAAAAAAAAfffffffffffffffffAAAAAAAAAAAAAAAAAAAAAAAAAAAAAAAAAAAAAAAAAAAAA",
        "AAAAAAAAAAAAAAAAAAAAAAAAAAAAAAAAAAfffffffffffffffffAAAAAAAAAAAAAAAAAAAAAAAAAAAAAAAAAAAAAAAAAAAAA",
        "AAAAAAAAAAAAAAAAAAAAAAAAAAAAAAAAAAfffffffYfffffffffAAAAAAAAAAAAAAAAAAAAAAAAAAAAAAAAAAAAAAAAAAAAA",
        "AAAAAAAAAAAAAAAAAAAAAAAAAAAAAAAAAAAAfffffffffffffAAAAAAAAAAAAAAAAAAAAAAAAAAAAAAAAAAAAAAAAAAAAAAA",
        "AAAAfffffffAAAAAAAAAAAAAAAAAAAAAAAAffffffAAAffffffAAAAAAAAAAAAAAAAAAAAAAAAAfffffAAAAAAAAAAAAAAAA",
        "AAAfffYffffffAAAAAAAAAAAAAAAAAAAffffffAAAAAAAAAfffffffAAAAAAAAAAAAAAAAAAffffYfffffAAAAAAAAAAAAAA",
        "AAfffffffffffffAAAAAAAAAAAAAAAffffffAAAAAAAAAAAAfffffffAAAAAAAAAAAAAAAfffffffffffffAAAAAAAAAAAAA",
        "AAffffffffffffffAAAAAAAAAAAfffffffAAAAAAAAAAAAAAAAfffffffAAAAAAAAAAAAffffffffffffffAAAAAAAAAAAAA",
        "AAffffQfffffffffffffffffffffffffAAAAAAAAAAAAAAAAAAAAffffffffffffffffffffffffffQffffAAAAAAAAAAAAA",
        "AAffffffffffffffffffffffffffffAAAAAAAAAAAAAAAAAAAAAAAAfffffffffffffffffffffffffffffAAAAAAAAAAAAA",
        "AAffffffZffffffffffffffffffAAAAAAAAAAAAAAAAAAAAAAAAAAAAAAfffffffffffffffffZffffffffAAAAAAAAAAAAA",
        "AAAfffffffffffffffffffff>>>AAAAAAAAAAAAAAAAAAAAAAAAAAAAAA>>>ffffffffffffffffffffffAAAAAAAAAAAAAA",
        "AAAAfffffffffffAAAAAAAAAAAAAAAAAAAAAAAAAAAAAAAAAAAAAAAAAAAAAAAAAAAAAAAAAfffffffffAAAAAAAAAAAAAAA",
        "AAAAAffffffffffAAAAAAAAAAAAAAAAAAAAAAAAAAAAAAAAAAAAAAAAAAAAAAAAAAAAAAAAfffffffffAAAAAAAAAAAAAAAA",
        "AAAAAAAAAAAffffAAAAAAAAAAAAAAAAAAAAAAAAAAAAAAAAAAAAAAAAAAAAAAAAAAAAAAAAffffAAAAAAAAAAAAAAAAAAAAA",
        "AAAAAAAAAAAAAfffAAAAAAAAAAAAAAAAAAAAAAAAAAAAAAAAAAAAAAAAAAAAAAAAAAAAAAfffAAAAAAAAAAAAAAAAAAAAAAA",
        "AAAAAAAAAAAAAfffAAAAAAAAAAAAAAAAAAAAAAAAAAAAAAAAAAAAAAAAAAAAAAAAAAAAAAfffAAAAAAAAAAAAAAAAAAAAAAA",
        "AAAAAAAAAAAAAfffAAAAAAAAAAAAAAAAAAAAAAAAAAAAAAAAAAAAAAAAAAAAAAAAAAAAAAfffAAAAAAAAAAAAAAAAAAAAAAA",
        "AAAAAAAAAAAAAAfffAAAAAAAAAAAAAAAAAAAAAAAAAAAAAAAAAAAAAAAAAAAAAAAAAAAAfffAAAAAAAAAAAAAAAAAAAAAAAA",
        "AAAAAAAAAAAAAAfffAAAAAAAAAAAAAAAAAAAAAAAAAAAAAAAAAAAAAAAAAAAAAAAAAAAAfffAAAAAAAAAAAAAAAAAAAAAAAA",
        "AAAAAAAAAAAAAAfffAAAAAAAAAAAAAAAAAAAAAAAAAAAAAAAAAAAAAAAAAAAAAAAAAAAAfffAAAAAAAAAAAAAAAAAAAAAAAA",
        "AAAAAAAAAAAAAAfffAAAAAAAAAAAAAAAAAAAAAAAAAAAAAAAAAAAAAAAAAAAAAAAAAAAAfffAAAAAAAAAAAAAAAAAAAAAAAA",
        "AAAAAAAAAAAAAAAfffAAAAAAAAAAAAAAAAAAAAAAAAAAAAAAAAAAAAAAAAAAAAAAAAAAfffAAAAAAAAAAAAAAAAAAAAAAAAA",
        "AAAAAAAAAAAAAAAfffAAAAAAAAAAAAAAAAAAAAAAAAAAAAAAAAAAAAAAAAAAAAAAAAAAfffAAAAAAAAAAAAAAAAAAAAAAAAA",
        "AAAAAAAAAAAAAAAfffAAAAAAAAAAAAAAAAAAAAAAAAAAAAAAAAAAAAAAAAAAAAAAAAAAfffAAAAAAAAAAAAAAAAAAAAAAAAA",
        "AAAAAAAAAAAAAAAfffAAAAAAAAAAAAAAAAAAAAAAAAAAAAAAAAAAAAAAAAAAAAAAAAAAfffAAAAAAAAAAAAAAAAAAAAAAAAA",
        "AAAAAAAAAAAAAAAfffAAAAAAAAAAAAAAAAAAAAAAAAAAAAAAAAAAAAAAAAAAAAAAAAAAfffAAAAAAAAAAAAAAAAAAAAAAAAA",
        "AAAAAAAAAAAAAAAfffAAAAAAAAAAAAAAAAAAAAAAAAAAAAAAAAAAAAAAAAAAAAAAAAAAfffAAAAAAAAAAAAAAAAAAAAAAAAA",
        "AAAAAAAAAAAAAAAAfffAAAAAAAAAAAAAAAAAAAAAAAAAAAAAAAAAAAAAAAAAAAAAAAAfffAAAAAAAAAAAAAAAAAAAAAAAAAA",
        "AAAAAAAAAAAAAAAAfffAAAAAAAAAAAAAAAAAAAAAAAAAAAAAAAAAAAAAAAAAAAAAAAAfffAAAAAAAAAAAAAAAAAAAAAAAAAA",
        "AAAAAAAAAAAAAAAAfffAAAAAAAAAAAAAAAAAAAAAAAAAAAAAAAAAAAAAAAAAAAAAAAAfffAAAAAAAAAAAAAAAAAAAAAAAAAA",
        "AAAAAAAAAAAAAAAAfffAAAAAAAAAAAAAAAAAAAAAAAAAAAAAAAAAAAAAAAAAAAAAAAAfffAAAAAAAAAAAAAAAAAAAAAAAAAA",
        "AAAAAAAAAAAAAAAAfffAAAAAAAAAAAAAAAAAAAAAAAAAAAAAAAAAAAAAAAAAAAAAAAAfffAAAAAAAAAAAAAAAAAAAAAAAAAA",
        "AAAAAAAAAAAAAAAAAfffAAAAAAAAAAAAAAAAAAAAAAAAAAAAAAAAAAAAAAAAAAAAAAfffAAAAAAAAAAAAAAAAAAAAAAAAAAA",
        "AAAAAAAAAAAAAAAAAfffAAAAAAAAAAAAAAAAAAAAAAAAAAAAAAAAAAAAAAAAAAAAAAfffAAAAAAAAAAAAAAAAAAAAAAAAAAA",
        "AAAAAAAAAAAAAAAAAfffAAAAAAAAAAAAAAAAAAAAAAAAAAAAAAAAAAAAAAAAAAAAAAfffAAAAAAAAAAAAAAAAAAAAAAAAAAA",
        "AAAAAAAAAAAAAAAAAfffAAAAAAAAAAAAAAAAAAAAAAAAAAAAAAAAAAAAAAAAAAAAAAfffAAAAAAAAAAAAAAAAAAAAAAAAAAA",
        "AAAAAAAAAAAAAAAAAAfffAAAAAAAAAAAAAAAAAAAAAAAAAAAAAAAAAAAAAAAAAAAAfffAAAAAAAAAAAAAAAAAAAAAAAAAAAA",
        "AAAAAAAAAAAAAAAAAAffffAAAAAAAAAAAAAAAAAAAAAAAAAAAAAAAAAAAAAAAAAAffffAAAAAAAAAAAAAAAAAAAAAAAAAAAA",
        "AAAAAAAAAAAAAAAAfffffffffffffffffffffffffffffffffffffffffffffffffffffAAAAAAAAAAAAAAAAAAAAAAAAAAA",
        "AAAAAAAAAAAAAAAAfffffffffffffffffffffffffffffffffffffffffffffffffffffAAAAAAAAAAAAAAAAAAAAAAAAAAA",
        "AAAAAAAAAAAAAAfffYfffffffffffffffffffffffffffffffffffffffffffffffffffffAAAAAAAAAAAAAAAAAAAAAAAAA",
        "AAAAAAAAAAAAfffffffffffffffffAAAAAAAAAAAAAAAAAAAAAAAAAAAAffffffffffffffffAAAAAAAAAAAAAAAAAAAAAAA",
        "AAAAAAAAAAAAffffffffffffffffAAAAAAAAAAAAAAAAAAAAAAAAAAAAAAfffYffffffffffffAAAAAAAAAAAAAAAAAAAAAA",
        "AAAAAAAAAAAAffffffffffffffffAAAAAAAAAAAAAAAAAAAAAAAAAAAAAAffffffffffffffffAAAAAAAAAAAAAAAAAAAAAA",
        "AAAAAAAAAAAAfffffffQfffffffAAAAAAAAAAAAAAAAAAAAAAAAAAAAAAAAffffffffQffffffAAAAAAAAAAAAAAAAAAAAAA",
        "AAAAAAAAAAAAfffffffffffffffAAAAAAAAAAAAAAAAAAAAAAAAAAAAAAAAfffffffffffffffAAAAAAAAAAAAAAAAAAAAAA",
        "AAAAAAAAAAAAAffffffZfffffffAAAAAAAAAAAAAAAAAAAAAAAAAAAAAAAAffffffffffffffAAAAAAAAAAAAAAAAAAAAAAA",
        "AAAAAAAAAAAAAAfffffffffffAAAAAAAAAAAAAAAAAAAAAAAAAAAAAAAAAAAAffffffZffffAAAAAAAAAAAAAAAAAAAAAAAA",
        "AAAAAAAAAAAAAAAfffffffffAAAAAAAAAAAAAAAAAAAAAAAAAAAAAAAAAAAAAAfffffffffAAAAAAAAAAAAAAAAAAAAAAAAA",
        "AAAAAAAAAAAAAAAAfffffffAAAAAAAAAAAAAAAAAAAAAAAAAAAAAAAAAAAAAAAAfffffffAAAAAAAAAAAAAAAAAAAAAAAAAA",
        "AAAAAAAAAAAAAAAAAAAAAAAAAAAAAAAAAAAAAAAAAAAAAAAAAAAAAAAAAAAAAAAAAAAAAAAAAAAAAAAAAAAAAAAAAAAAAAAA",
        "AAAAAAAAAAAAAAAAAAAAAAAAAAAAAAAAAAAAAAAAAAAAAAAAAAAAAAAAAAAAAAAAAAAAAAAAAAAAAAAAAAAAAAAAAAAAAAAA",
        "AAAAAAAAAAAAAAAAAAAAAAAAAAAAAAAAAAAAAAAAAAAAAAAAAAAAAAAAAAAAAAAAAAAAAAAAAAAAAAAAAAAAAAAAAAAAAAAA",
        "AAAAAAAAAAAAAAAAAAAAAAAAAAAAAAAAAAAAAAAAAAAAAAAAAAAAAAAAAAAAAAAAAAAAAAAAAAAAAAAAAAAAAAAAAAAAAAAA",
        "AAAAAAAAAAAAAAAAAAAAAAAAAAAAAAAAAAAAAAAAAAAAAAAAAAAAAAAAAAAAAAAAAAAAAAAAAAAAAAAAAAAAAAAAAAAAAAAA",
        "AAAAAAAAAAAAAAAAAAAAAAAAAAAAAAAAAAAAAAAAAAAAAAAAAAAAAAAAAAAAAAAAAAAAAAAAAAAAAAAAAAAAAAAAAAAAAAAA",
        "AAAAAAAAAAAAAAAAAAAAAAAAAAAAAAAAAAAAAAAAAAAAAAAAAAAAAAAAAAAAAAAAAAAAAAAAAAAAAAAAAAAAAAAAAAAAAAAA",
        "AAAAAAAAAAAAAAAAAAAAAAAAAAAAAAAAAAAAAAAAAAAAAAAAAAAAAAAAAAAAAAAAAAAAAAAAAAAAAAAAAAAAAAAAAAAAAAAA",
        "AAAAAAAAAAAAAAAAAAAAAAAAAAAAAAAAAAAAAAAAAAAAAAAAAAAAAAAAAAAAAAAAAAAAAAAAAAAAAAAAAAAAAAAAAAAAAAAA",
        "AAAAAAAAAAAAAAAAAAAAAAAAAAAAAAAAAAAAAAAAAAAAAAAAAAAAAAAAAAAAAAAAAAAAAAAAAAAAAAAAAAAAAAAAAAAAAAAA",
        "AAAAAAAAAAAAAAAAAAAAAAAAAAAAAAAAAAAAAAAAAAAAAAAAAAAAAAAAAAAAAAAAAAAAAAAAAAAAAAAAAAAAAAAAAAAAAAAA",
        "AAAAAAAAAAAAAAAAAAAAAAAAAAAAAAAAAAAAAAAAAAAAAAAAAAAAAAAAAAAAAAAAAAAAAAAAAAAAAAAAAAAAAAAAAAAAAAAA",
        "AAAAAAAAAAAAAAAAAAAAAAAAAAAAAAAAAAAAAAAAAAAAAAAAAAAAAAAAAAAAAAAAAAAAAAAAAAAAAAAAAAAAAAAAAAAAAAAA"
      ],
      "palettes": [ "demonfort_palette" ],
      "items": {  },
      "place_loot": [  ],
      "place_monsters": [  ],
      "monsters": { "Z": { "monster": "GROUP_MAGES", "chance": 100 },
                    "Y": { "monster": "GROUP_MAGES", "chance": 100 } },
      "vehicles": { "U": { "vehicle": "cannon_3in", "chance": 100 }, "Q": { "vehicle": "cannon_3in_plugged", "chance": 100 } }
    }
  },
  {
    "type": "overmap_terrain",
    "id": [
      "demonfort_1a",
      "demonfort_2a",
      "demonfort_3a",
      "demonfort_4a",
      "demonfort_1b",
      "demonfort_2b",
      "demonfort_3b",
      "demonfort_4b",
      "demonfort_1c",
      "demonfort_2c",
      "demonfort_3c",
      "demonfort_4c",
      "demonfort_1a_1",
      "demonfort_2a_1",
      "demonfort_3a_1",
      "demonfort_4a_1",
      "demonfort_1b_1",
      "demonfort_2b_1",
      "demonfort_3b_1",
      "demonfort_4b_1",
      "demonfort_1c_1",
      "demonfort_2c_1",
      "demonfort_3c_1",
      "demonfort_4c_1"
    ],
    "name": "demonic fortress",
    "sym": "F",
    "color": "black",
    "see_cost": 3
  },
  {
    "type": "overmap_special",
    "id": "Demonic Fortress",
    "overmaps": [
      { "point": [ 0, 0, 0 ], "overmap": "demonfort_1a_north" },
      { "point": [ 1, 0, 0 ], "overmap": "demonfort_2a_north" },
      { "point": [ 2, 0, 0 ], "overmap": "demonfort_3a_north" },
      { "point": [ 3, 0, 0 ], "overmap": "demonfort_4a_north" },
      { "point": [ 0, 1, 0 ], "overmap": "demonfort_1b_north" },
      { "point": [ 1, 1, 0 ], "overmap": "demonfort_2b_north" },
      { "point": [ 2, 1, 0 ], "overmap": "demonfort_3b_north" },
      { "point": [ 3, 1, 0 ], "overmap": "demonfort_4b_north" },
      { "point": [ 0, 2, 0 ], "overmap": "demonfort_1c_north" },
      { "point": [ 1, 2, 0 ], "overmap": "demonfort_2c_north" },
      { "point": [ 2, 2, 0 ], "overmap": "demonfort_3c_north" },
      { "point": [ 3, 2, 0 ], "overmap": "demonfort_4c_north" },
      { "point": [ 0, 0, 1 ], "overmap": "demonfort_1a_1_north" },
      { "point": [ 1, 0, 1 ], "overmap": "demonfort_2a_1_north" },
      { "point": [ 2, 0, 1 ], "overmap": "demonfort_3a_1_north" },
      { "point": [ 3, 0, 1 ], "overmap": "demonfort_4a_1_north" },
      { "point": [ 0, 1, 1 ], "overmap": "demonfort_1b_1_north" },
      { "point": [ 1, 1, 1 ], "overmap": "demonfort_2b_1_north" },
      { "point": [ 2, 1, 1 ], "overmap": "demonfort_3b_1_north" },
      { "point": [ 3, 1, 1 ], "overmap": "demonfort_4b_1_north" },
      { "point": [ 0, 2, 1 ], "overmap": "demonfort_1c_1_north" },
      { "point": [ 1, 2, 1 ], "overmap": "demonfort_2c_1_north" },
      { "point": [ 2, 2, 1 ], "overmap": "demonfort_3c_1_north" },
      { "point": [ 3, 2, 1 ], "overmap": "demonfort_4c_1_north" }
    ],
    "locations": [ "land" ],
    "city_distance": [ -1, 1 ],
    "city_sizes": [ 0, 12 ],
    "occurrences": [ 30, 100 ],
    "flags": [ "UNIQUE", "MAN_MADE", "URBAN", "RISK_HIGH" ]
  }
]
